11111111111
100100000C1
10000011001
1P00011E001
11111111111
