1111111111111
1C000000000C1
1000E11111001
1P0000C000C01
1111111111111