111111
1000C1
1C0E01
1P0001
111111
